111112222
132212222
124412111
124212151
111211151
211222251
212221221
212221111
211111222